아우로라 - 화려한 북극광과 같은 아름다운 광경
실버스피어 - 은빛으로 빛나는 세계
에델바이트 - 고귀하고 숭고한 분위기를 갖는 행성
노바리스 - 새로운 별이 태어나는 곳
플루톤 - 신비로운 분위기를 갖는 외계 행성
크림슨타이드 - 진한 붉은 물결이 밀려오는 행성
세렌디아 - 평화롭고 운치 있는 행성
베르니아 - 푸른 빛깔을 띤 아름다운 세계
아이리스 - 다채로운 무지개가 떠 있는 곳
루미나라 - 빛나는 땅과 바다가 어우러진 행복한 행성
플로리스 - 화려한 꽃들이 가득한 아름다운 섬나라
루나스 - 달과 같은 차가움과 우아함을 갖춘 행성
신디아 - 신비로운 에너지가 넘치는 행성
엑스칼리버 - 고대 전설의 검을 모티프로 한 행성
헤일리스 - 유성우와 함께 운행하는 행성
세르시스 - 천재들이 모여있는 곳
노바스 - 번개와 같이 빠른 속도로 움직이는 행성
엘리시움 - 무궁무진한 행복과 안식의 땅
아폴로니아 - 아름다운 음악과 예술이 번창하는 행성
네오포트 - 미래 지향적인 과학 기술이 발달한 행성
노벨리아 - 혁신적인 발견과 연구가 이루어지는 행성
헤일리스타 - 놀라운 천체들이 빛나는 행성
아르케이디아 - 옛날의 명예와 영광이 살아 숨쉬는 곳
아우리엘 - 높은 지성과 지혜가 깃든 행성
세이퍼스 - 푸른 바다와 그림같은 풍경을 갖춘 행성
프로토스 - 진화의 초기 단계를 겪고 있는 행성
라이트스톤 - 빛나는 보석 같은 세계
노바라이트 - 새로운 빛이 계속해서 불어오는 곳
에메랄드 - 녹색의 숲과 초원으로 뒤덮인 행성
아스테라 - 다양한 별들이 함께 빛나는 우주 공간
카오스 - 혼돈과 질서가 공존하는 행성
그라비티스 - 중력의 힘이 강한 곳
세피아 - 세계가 구식으로 보이는 곳
에레스 - 전투와 용감함이 중요시 되는 행성
티탄스 - 거대하고 강력한 존재들이 서식하는 곳
쿼사 - 신비한 역사와 전설이 담긴 행성
에덴스 - 신성한 휴식과 평화가 가득한 행성
아리아스 - 아름다운 음악과 예술이 번창하는 곳
솔라스 - 해와 관련된 힘이 강한 행성
아폴로스 - 고대 신화의 영웅을 연상케 하는 행성
에이리언 - 외계 생명체의 서식지가 되는 곳
라그나 - 불과 전쟁의 힘이 과시되는 곳
크로무스 - 시간의 흐름이 느린 곳
루나리스 - 달과 관련된 신비로움을 품은 행성
아르테미스 - 사냥과 자연의 여신을 떠올리게 하는 행성
세레니스 - 고요하고 평화로운 행성
헬리오스 - 태양과 관련된 힘이 강한 행성
스테이시스 - 시간이 멈춰있는 듯한 행성
노바티스 - 새로운 별이 태어나는 중인 행성
프라이머스 - 우주의 기원과 진화가 시작된 곳
미스트라 - 미지의 영역으로 향하는 행성
블루노바 - 파란색 별이 폭발하는 듯한 행성
아테나 - 지혜와 전략이 중요시 되는 곳
넵튠스 - 바다와 물 속 생물이 다양한 행성
크리스탈로스 - 수정과 보석이 풍부한 행성
플로라 - 식물과 자연이 풍부한 행성
아리아드네 - 복잡한 미로와 모험을 품은 행성
제피루스 - 빠른 속도와 우아한 운동을 자랑하는 행성
피닉스 - 부활과 재탄생의 상징이 빛나는 곳
블랙스톤 - 심연의 깊은 어둠과 신비로움을 담은 행성
크리오스 - 얼음과 빙하가 광활하게 펼쳐진 곳
미라지 - 신비로운 광합성이 일어나는 곳
타이탄스 - 거대하고 강력한 힘이 숨쉬는 행성
헤라클레스 - 영웅적인 모험이 넘치는 곳
아폴로 - 예술과 음악이 번창하는 곳
오라클 - 미래를 예지하는 성스러운 행성
노바타이거 - 위협적이고 강력한 생명체들이 서식하는 곳
레지오 - 영예와 귀인들의 영지
아르카디아 - 낙원과 같은 평화로운 곳
레베카 - 공정과 정의가 중요시되는 행성
노바리움 - 신비로운 빛과 에너지가 넘치는 곳
엘리시움 - 영원한 행복과 안식이 기다리는 곳
노바플라이어 - 높은 기술력과 우주 비행 기술이 발달한 곳
코스모스 - 우주의 모든 것을 품은 곳
트리스탄 - 용감한 모험가들의 활동이 일어나는 곳
아르티쉬아 - 아름다운 예술과 문화가 풍부한 행성
노바크라운 - 우주의 왕관과 같이 빛나는 행성
루시퍼 - 어둠과 빛이 공존하는 신비로운 행성
실버라이트 - 은빛으로 빛나는 세계
라이더스 - 용맹하고 자유로운 정신을 가진 행성
티타니아 - 여왕과 같은 위엄과 아름다움을 갖춘 행성